169
8
22 22 22 4 0 0 0 0 0 0 0 0 0 0 0 0 0 0 0 0 0 0 0 0 0 0 0 0 0 0 0 0 0 0 0 0 0 0 0 0 0 0 0 0 0 0 0 0 0 0 0 0 0 0 0 0 0 0 0 0 0 0 0 0 0 0 0 0 0 0 0 0 0 0 0 0 0 0 0 0 0 0 0 0 0 0 0 0 0 0 0 0 0 0 0 0 0 0 0 0 0 0 0 0 0 0 0 0 0 0 0 0 0 0 0 0 0 0 0 0 0 0 0 11 11 11 0 11 11 11 0 0 0 0 0 0 0 0 0 0 0 0 0 0 0 0 0 0 0 0 0 3 22 22 22 22 22 22 22 22 22 22 22 22 22 22 22 22 22
22 22 19 0 0 0 0 0 0 0 0 0 0 0 0 0 0 0 0 0 0 0 0 0 0 0 0 0 0 0 0 0 0 0 0 0 0 0 0 0 0 0 0 0 0 0 0 0 0 0 0 0 0 0 0 0 0 0 0 0 0 0 0 0 0 0 0 0 0 0 0 0 0 0 0 0 0 0 0 0 0 0 0 0 0 0 0 0 0 0 0 0 0 0 0 0 0 0 0 0 0 0 0 0 0 11 0 0 0 9 0 0 0 0 0 0 0 0 0 0 0 0 0 23 24 25 0 23 24 25 0 0 0 0 0 0 0 0 0 0 0 0 0 0 0 0 0 0 0 0 0 0 18 22 22 22 19 17 17 17 17 17 17 17 17 17 18 22 22
22 19 0 0 0 0 0 0 0 0 0 0 0 0 0 0 0 0 0 0 0 0 0 14 0 0 0 0 0 0 0 0 0 0 0 0 0 0 0 0 0 0 0 0 0 0 0 0 0 0 0 0 0 0 0 9 9 0 0 0 0 0 0 0 0 0 0 0 0 0 0 0 0 0 0 0 0 0 0 0 0 0 0 0 0 0 0 0 0 0 0 0 9 0 0 0 0 0 0 11 0 0 0 23 24 25 1 21 21 21 2 0 0 0 0 0 10 0 0 0 0 0 0 0 0 0 10 0 0 0 0 0 0 0 0 0 0 0 0 0 0 0 0 0 0 0 0 0 0 0 0 0 0 18 22 19 0 0 0 1 21 8 21 2 0 0 0 18 22
22 4 0 0 0 12 0 0 0 15 0 0 0 13 0 10 0 0 0 0 10 0 0 0 0 0 10 9 10 0 0 0 10 0 0 0 0 0 16 0 0 0 0 0 0 0 0 0 0 0 0 0 10 0 0 23 25 0 0 10 0 0 0 0 0 0 0 0 0 0 0 0 0 0 0 0 0 11 0 0 10 0 0 0 0 0 0 0 0 0 0 1 21 2 0 0 0 0 23 24 25 0 0 0 0 0 0 18 22 22 4 0 0 0 23 24 25 0 0 0 0 0 0 0 0 23 24 25 0 0 0 1 21 2 0 0 0 0 0 0 0 0 0 0 0 0 0 0 0 1 21 2 0 3 22 4 0 0 0 0 17 0 17 0 0 0 0 3 22
22 4 0 0 0 0 0 0 0 0 0 0 0 0 1 21 2 1 21 21 21 2 0 0 0 0 23 24 25 0 0 1 21 21 21 2 0 0 0 0 0 0 0 0 0 0 0 0 0 10 0 1 21 2 0 0 0 0 1 21 2 0 10 0 0 0 0 0 0 0 0 0 0 9 0 0 1 21 21 21 21 21 2 0 11 0 1 21 2 0 0 3 22 4 0 0 0 0 0 0 0 0 0 10 0 0 0 0 18 5 21 21 2 0 0 0 0 0 0 10 0 0 0 9 0 0 0 0 0 9 0 1 21 21 21 2 0 9 0 0 0 0 0 0 0 0 0 0 1 21 6 4 0 3 22 4 0 0 0 0 0 0 0 0 0 0 0 3 22
22 4 0 0 0 0 0 0 0 0 0 0 0 0 1 21 21 21 6 22 22 4 0 0 0 0 0 0 0 0 0 3 22 22 22 4 0 0 9 0 0 1 21 2 0 0 10 0 1 21 2 3 5 21 2 0 0 1 21 6 4 1 21 2 0 10 0 0 0 0 0 23 24 25 0 0 3 22 22 22 22 5 21 21 21 21 21 21 2 0 1 21 6 4 0 0 0 0 0 0 0 0 0 23 25 0 0 0 3 22 19 17 0 0 0 0 0 0 23 24 25 0 1 21 2 0 0 0 1 21 2 3 22 22 5 21 21 21 2 0 9 0 0 0 0 0 0 1 21 6 22 4 0 3 22 4 0 0 0 0 0 0 0 0 0 0 0 3 22
22 4 0 0 0 10 0 0 0 9 0 11 0 1 21 6 22 22 22 22 22 4 0 0 0 0 0 0 0 0 0 3 22 22 5 21 21 21 21 21 21 21 6 4 11 1 21 2 3 22 4 3 22 19 23 24 24 25 18 22 4 3 22 4 1 21 2 0 0 10 0 0 0 0 0 0 3 22 22 22 22 22 22 22 22 22 22 5 21 21 21 21 21 21 21 2 9 0 0 1 21 2 0 0 0 0 0 10 3 22 4 0 9 0 0 0 0 0 0 0 0 0 3 5 21 2 11 1 21 6 4 3 22 22 22 22 22 5 21 21 21 2 0 9 0 0 1 21 6 22 22 4 0 10 17 10 0 0 0 0 0 0 0 0 0 0 0 3 22
5 21 21 21 21 21 21 21 21 21 21 21 21 21 21 21 6 22 22 22 22 4 0 0 0 0 0 0 0 0 0 3 22 22 22 22 22 22 22 22 22 5 21 21 21 21 21 2 3 22 4 3 22 4 0 0 0 0 3 22 4 3 22 4 3 5 21 21 21 21 2 0 0 0 0 0 3 22 22 22 22 22 22 22 22 22 22 22 22 22 22 22 22 22 5 21 21 21 21 21 21 21 2 0 0 1 21 21 21 7 21 21 21 2 0 0 0 0 0 0 0 0 3 22 5 21 21 21 6 22 4 3 22 22 22 22 22 22 22 22 5 21 21 21 21 21 21 21 21 21 21 21 8 21 21 21 21 21 21 21 21 21 21 21 21 21 21 21 6